доход: доход дохода
изолятор: изоляторе
предотвращение: предотвращения предотвращение предотвращению
регулирование: регулирование регулированию
второй: вторую вторая второй
предпочтение: предпочтения
организовать: организованную организовавшее организованных организованной
совершение: совершению совершения совершение совершении
основываться: основывается
сообщество: сообщества сообщество сообществом сообществе
воспитательный: воспитательную воспитательных воспитательной
принцип: принципа принципы принципах принцип
федеральный: федерального федеральных федеральный федеральным
основный: основных основное основному основного основным
заменяться: заменяются заменяется
стать: статей
взаимность: взаимности
статья: статье статьей статьями статью статья статьи
несовершеннолетие: несовершеннолетие
рф: рф
поглощение: поглощения
вред: вред вреда
обоснованный: обоснованным обоснованном обоснованный обоснованного
причинить: причиненных причиненный причинен причиненного
коммерческий: коммерческого
законодательство: законодательством законодательство
новый: нового новым новых новый новые новое
быть: е был были будет быть было
назначить: назначена назначить назначенных назначенного назначенному назначены назначен назначенном назначено назначив назначенное
находиться: находящейся находящиеся находящегося находилось находятся находящемся
освободить: освободить освобождено освобожденного
посягательство: посягательство посягательства посягательств
необходимый: необходимой необходимых необходимая
смысл: смысла
должность: должности должностях
контрактный: контрактной контрактного
стоимость: стоимости
мера: мерами мер мера мере меры
кодекс: кодекс кодекса кодексу кодексом
технический: технических
степень: степени степень степенью
исполнение: исполнении исполнения исполнением исполнение
несообщение: несообщение
человек: человека людей
применяться: применяется применяются
четырнадцать: четырнадцати
тяжкий: тяжкие тяжкому тяжкого тяжкое тяжкими тяжких тяжким тяжкую
совместный: совместном совместного совместное
равный: равный равны равной
отбытие: отбытия
смотреть: см
достигнуть: достигших достигшие достигшее достигнута достиг достигшим достигшего
комиссия: комиссии
исключительный: исключительных исключительная исключительными исключительной
малолетний: малолетних малолетнего
часть: частей частями частью часть частях части
состоять: состоит
язык: языка
личность: личности личность
преступник: преступника
неоконченный: неоконченное неоконченным
обязательство: обязательства
совершить: совершено совершившие совершены совершившего совершившим совершившее совершивших совершил совершившему
назначать: назначаемая назначающий назначает назначаемое назначаемого назначая
низкий: низшего
осудить: осужденным осужденный осуждено осужденного осуждены осужденными осужденных осужденному
превышение: превышением превышение превышения
наказание: наказание наказания наказаний наказании наказанием наказанию
предыдущий: предыдущего предыдущему предыдущей
истечь: истекли
сам: само
связь: связи
орган: органах органа органам орган органов органами органом
наказуемый: наказуемое
пребывание: пребывания
действовать: действующим действующих действовавшим
условно-досрочный: условно-досрочному условно-досрочного условно-досрочно условно-досрочном условно-досрочное
восстановление: восстановления
деятельность: деятельности деятельность деятельностью
удаться: удалось
возложить: возложены возложенные возложенных возложить
рассчитывать: рассчитывало
форма: формами формы
обратный: обратная обратной обратную
фз: фз
гауптвахта: гауптвахте
устранять: устраняющий
соучастник: соучастниками соучастников соучастники соучастнику
заключение: заключение заключения
предусмотренный: предусмотренные предусмотренного предусмотренный предусмотренным предусмотренное
экстремальный: экстремальных
признать: признаны признана признать признанным признано признает
выдать: выданному выданы выдавшего
деятель: деятеля
обязать: обязанным
заключаться: заключается заключаются
косвенно: косвенно
риск: риском риска риск риски
женщина: женщинам женщиной женщины
приговор: приговором приговора приговору приговоров
первый: первой первому первая
полностью: полностью
организатор: организатор организатора организатором
вынести: вынести
назначение: назначение назначения назначением назначении
образовательный: образовательной
предупреждение: предупреждения предупреждение
причинение: причинения причинение
абзац: абзац
руководить: руководить руководившее
опасный: опасном опасное опасного опасные опасным опасными опасных
конфликт: конфликта
деяние: деяния деянию деяние деянии деяний
правомерный: правомерной правомерные
исправление: исправлению исправление исправления
момент: момента момент моменту
категория: категорию категории
двадцать: двадцать двадцати
обеспечить: обеспечить
уголовно-правовой: уголовно-правового уголовно-правовые
строгий: строгих строгим строгой строгое строгий строгого
отбывать: отбывающее отбывающему отбывают отбывавшим отбывал отбывающих отбывающим отбывающего отбывает
они: им ним них они ими их
один: одной одному одного одну одно один
два: двух два две двум двумя
судимость: судимости судимость
уведомление: уведомления
группа: группу группой группы групп
немой: нем
применение: применением применении применения применение
преступление: преступление преступлений преступлении преступлению преступлением преступлениями преступления преступлениям
подстрекатель: подстрекатель подстрекателя подстрекателем
повод: поводом
настоящий: настоящему настоящим настоящий настоящего настоящей
допускаться: допускается
условие: условием условий условии условиях условия
руководство: руководством руководство
вступление: вступления
установленный: установленным установленные установленного
соответствовать: соответствовать соответствующее соответствующей соответствуют
объект: объекты
иностранный: иностранном иностранных иностранные иностранными иностранным иностранному иностранного
представлять: представляющее представляющих
размер: размеру размер размера размере
уголовный: уголовного уголовному уголовной уголовную уголовным уголовный уголовных уголовное уголовная
тот: тому том те тот тех
заменить: заменена заменить
исключать: исключающее исключает исключающим исключающие
расовый: расовой
осуждение: осуждения осуждение осуждении
вооружённый: вооруженном вооруженного
убийство: убийство
пятидесятипятилетний: пятидесятипятилетнего
внутренний: внутренних
следствие: следствия
период: период периода
отдельный: отдельные
число: числа числе
предел: пределы пределами предела пределах пределов
другой: другие другими другого другое другим других
континентальный: континентальном
дом: доме
обязательный: обязательных обязательного обязательным обязательные
нарушение: нарушении нарушение нарушений нарушения
отношение: отношений отношения отношение отношении
неделя: недель
социальный: социальные социальную социального социальной
четвёртый: четвертой четвертая
принадлежность: принадлежности
администрация: администрации
вывод: выводу
каждый: каждое каждому каждого
мягкий: мягкий мягкое мягким мягкого
продлить: продлить продленного
дальнейший: дальнейшего дальнейшем
страховой: страховым
соучастие: соучастием соучастия соучастии соучастие
уходить: уходить
невиновный: невиновное невиновно
сообщение: сообщения сообщение сообщением
взрывчатый: взрывчатых
значение: значение
явно: явно
иметь: имеющему иметь имеет имеющих имеющим имеющей имеющий
строй: строя
отсутствие: отсутствии
данный: данное данного
уголовно-исполнительный: уголовно-исполнительным уголовно-исполнительными уголовно-исполнительной
год: лет года год годах
преступный: преступных преступного преступное преступной преступную преступным
закупка: закупок
остаться: оставшейся оставшуюся оставшегося
осуждаться: осуждалось осуждается
указанный: указанном указанных указанными указанные указанное указанная указанного
наиболее: наиболее
восемь: восьми восемь
предоставляться: предоставлялась
фактический: фактический фактических фактического
этот: этой этими эта этому эти этих
нападение: нападение нападения
уклоняться: уклоняется
характер: характером характер характера характеру
общественный: общественный общественной общественную общественного общественным
денежный: денежное денежных денежную денежного
место: места месту местах место
эксцесс: эксцессом эксцесс
расположить: расположенные
оказать: оказанного
расследование: расследованию
являться: являются являющееся является являлись являться
содействовать: содействовавшее
месть: мести
запретить: запрещенное
структурировать: структурированной
установить: установлено установлена установлены установленном
смягчающий: смягчающих смягчающее смягчающие смягчающий смягчающими
сопрячь: сопряженные сопряженного сопряжен сопряжено сопряженных
международный: международной международным международного
тяжёлый: тяжелых тяжелыми
больной: больным
который: которое которого которые которому котором которых которым
разбирательство: разбирательства разбирательство
право: правам прав права
только: только
детско-юношеский: детско-юношеского
явка: явка явки
отбывание: отбыванием отбывания отбывание отбывании
нормативный: нормативными
субъект: субъектом
труд: труду
заседатель: заседателями заседателей
кс: кс
осознавать: осознавать осознавало
государство: государств государства государством государству государстве
учитываться: учитываются учитываться учитывается
воздушный: воздушном воздушного
сговор: сговора сговор сговору
причиняться: причиняются причиняется
допустить: допустившее допущено
исправительный: исправительным исправительные исправительное исправительной исправительную исправительного исправительных
террористический: террористической террористическом террористический
единственный: единственный
существенно: существенно
обстоятельство: обстоятельствам обстоятельство обстоятельствах обстоятельства обстоятельствами обстоятельством обстоятельств
здоровье: здоровья здоровью
расстройство: расстройством расстройства расстройство расстройствами
целое: целом
ухудшать: ухудшающий
грабёж: грабеж
двукратный: двукратном двукратной
состояться: состояться
совокупность: совокупность совокупности совокупностью
вновь: вновь
месяц: месяцу месяцам месяцах месяц месяцев месяца
смертный: смертной смертная
признак: признаки признака
сила: сила силу силы
условный: условным условном условное условного
признаваться: признаются признается признавалось
мочь: могла могло могут мог может
деятельный: деятельного деятельным
педофилия: педофилией
предпринять: предпринятыми предприняло предпринятые предпринял
освобождение: освобождению освобождение освобождении освобождения
предоставление: предоставлением
занимать: занимать
розыск: розыску
учитывать: учитывая учитывает
предотвратить: предотвратили предотвратить предотвращенный
сержантский: сержантского
принудительный: принудительным принудительные принудительными принудительных
орудие: орудия орудий
привлечение: привлечения привлечении привлечение
изменить: изменить
вражда: вражды
исходить: исходя
перестать: перестали перестало
водный: водном водного
направить: направлено направленных направленные
безопасность: безопасности безопасность
допускать: допускало
судный: судна
обязанность: обязанность обязанности обязанностей
последствие: последствий последствия
участие: участием участия участие
поздний: позднее
полный: полном полной полного
особый: особой особого
соисполнитель: соисполнители соисполнителями
уполномоченный: уполномоченных уполномоченным
вклад: вклады вкладов
косвенный: косвенным
интерес: интересы интересам интересов
виновный: виновному виновен виновного виновным виновно
наличие: наличии наличие
вид: видам виды видами виде видов видом вида вид
беременность: беременности беременность
безразличный: безразлично
ограничение: ограничением ограничений ограничению ограничения ограничение ограничении
федерация: федерацией федерации
себя: собой себе
лицо: лица лицам лицом лицу лицами лиц лицо
ребёнок: детей ребенка
налог: налогам
четырнадцатилетний: четырнадцатилетнего
свидетельствовать: свидетельствуют
выезжать: выезжать
оказывать: оказывающей
психотропный: психотропных
пособник: пособника пособник пособником
продолжить: продолжить
ненависть: ненависти
скрыть: скрыть
рецидив: рецидиве рецидива рецидивом рецидив
заложник: заложника
приобрести: приобрести
режим: режима
реабилитация: реабилитацию
судья: судьи судья
лишение: лишению лишении лишения лишение лишением
содержать: содержит содержащее содержащего содержащих содержащим
роль: ролью роль
недоимка: недоимка
военный: военной военных военную военном
отмена: отмене отмена
политический: политической
посещать: посещать
дополнительный: дополнительное дополнительных дополнительные дополнительный дополнительного
зачёт: зачете зачета зачет
жизненный: жизненных
активный: активное активном активная
договориться: договорившиеся
погасить: погашенные
пп: пп
сильнодействующий: сильнодействующих
умышленный: умышленных умышленного умышленное умышленные
факт: факта
разбой: разбой
поощрение: поощрения
возмещение: возмещения возмещение возмещением
состав: составов состава составе состав
содержание: содержанием содержания содержании содержанию содержание
соглашение: соглашения соглашение
подразделяться: подразделяются
учреждение: учреждение учреждения учреждениями учреждений
декларирование: декларировании
склонить: склонившее склонить
покушение: покушением покушение
наряду: наряду
законодательный: законодательные
жизнь: жизни жизнь
следующий: следующие следующих
услуга: услуги услуг
выезд: выезд
повторно: повторно
прекращение: прекращение
возможный: возможным возможного
система: системы системе
оборона: оборона обороны
данные: данным
заключить: заключившим
выдача: выдачи выдача выдаче
химико-фармакологический: химико-фармакологических
боевой: боевых
местный: местного
лекарственный: лекарственных
подвижный: подвижного
банк: банках
наступление: наступления наступление
хранение: хранение
предусмотреть: предусмотрены предусмотрена предусмотренных предусмотренном предусмотрен предусмотренной предусмотрено
день: днях день дня дню
связать: связаны
счёт: счета счетов счет
общий: общие общей общем общего общих
издевательство: издевательством
колония-поселение: колониях-поселениях колонию-поселение колонии-поселении
закон: законом закона закон законов законы закону
беременная: беременным
постоянный: постоянного
такой: такого такое такие таких
штраф: штрафа штраф
помощь: помощью помощи
защита: защитой защиты защита защите
психический: психического психическое психическими психическим психическом
осуществлять: осуществляющим осуществляющий осуществляющего осуществлять
примириться: примирилось
удержание: удержания
вопрос: вопрос
помилование: помилования
шестой: шестой
совершенный: совершенными совершенным совершенного совершенному совершенное совершенных совершенные совершенном
неотбытый: неотбытая неотбытой неотбытую неотбытое
преднамеренный: преднамеренное
обстановка: обстановкой обстановки
срок: срок сроков сроки срока
истечение: истечении истечения истечением
привлечь: привлечен
несовершеннолетний: несовершеннолетних несовершеннолетней несовершеннолетним несовершеннолетнего несовершеннолетний
треть: третей трети
экономический: экономической
дисциплинарный: дисциплинарном дисциплинарной
четверть: четверти четвертей
обучение: обучению обучение обучения
состояние: состояния состоянии
бюджет: бюджет
соответствующий: соответствующие соответствующего соответствующими соответствующих
применить: применено применен применить
беспорядок: беспорядках
злостно: злостно
психофизиологический: психофизиологических
охватываться: охватывающегося охватывались
справедливый: справедливыми справедливое
камерный: камерного
нравственность: нравственности
возместить: возместившему возместило возмещен возместил
объединиться: объединившихся
устанавливаться: устанавливаются устанавливается
доставление: доставления
лишить: лишить
постановление: постановление постановлением
колония: колонии колониях колонию
порт: порту
вызывать: вызываемый
беспомощный: беспомощного
глава: глава главой
конституционный: конституционного
повреждение: повреждение
токсикомания: токсикомании
смочь: сможет
максимальный: максимального максимальное максимальный
болезненный: болезненного
собственность: собственности
пресечение: пресечения
потерпевший: потерпевшего потерпевшим
ранее: ранее
свой: своего своих своей свое своими своим
заранее: заранее
завладение: завладение
впервые: впервые
порядок: порядка порядке порядок
пройти: пройти
физический: физического физическими физических физическое
разрешаться: разрешается
вменяемость: вменяемости
приготовление: приготовлением приготовление приготовления
происхождение: происхождения
финансовый: финансовой
стихийный: стихийного
информация: информация информации
январь: января
взыскание: взыскания взыскание
получить: полученный полученного
случай: случае случаев случаях
население: населения
руководитель: руководитель
ложный: ложное ложные
работа: работ работы работами работам
любой: любом любой
определённый: определенными определенные определенное определенный определенных определенной определенном
предусмотрительность: предусмотрительности
способ: способом
иной: иные иного иными иное иных иным иной
результат: результаты результате
довести: доведено
арест: арестом ареста аресту арест
имущественный: имущественного
угрожать: угрожавшей угрожающей
согласование: согласованию
шельф: шельфе
призыв: призыву
тяжесть: тяжести
назначаться: назначаются назначается назначаться
поведение: поведение поведения поведением
неосторожность: неосторожности
норма: норме нормами нормах
зависеть: зависящие зависящим
цель: цель целями целью целях целей цели
пол: пола
участник: участники участника
объединить: объединены
повинная: повинной
незаконный: незаконные незаконных незаконном незаконным незаконное
загладить: загладил загладило
трудиться: трудиться
служба: службы службу службе
засчитываться: засчитывается засчитываются
раскаяние: раскаянием раскаяния
должностной: должностного
осуществляться: осуществляется
г: г
жительство: жительства
учёба: учебы учебе
превышать: превышает превышать превышающее
заведомо: заведомо
специализировать: специализированным специализированный
время: времени временем время
составлять: составлять
ситуация: ситуации
исчисление: исчисления исчисление
экспертиза: экспертизы
судебно-психиатрический: судебно-психиатрической
миллион: миллионов
десять: десяти десять
целесообразность: целесообразности
заслуживать: заслуживающим
приискание: приискание
единый: единым едином
расчёт: расчета
ядовитый: ядовитых
казнь: казнью казни казнь
неисполнение: неисполнение
ч: ч
выработка: выработке
малозначительность: малозначительности
почётный: почетного
несоответствие: несоответствие несоответствия
подлежащее: подлежащих подлежащие
транспорт: транспорта
административный: административное административной
относиться: относилось относятся относящиеся
запрещение: запрещении
способствовать: способствующих способствовало
добровольно: добровольно
нормативно-правовой: нормативно-правовому
пользоваться: пользуются
необходимость: необходимость необходимости
свободный: свободное
работник: работником работника
он: него он ему его
привлекаться: привлекаются привлекался привлекается
трудовой: трудовую
российский: российской
формально: формально
алкоголизм: алкоголизма
отягчать: отягчающих отягчающее отягчающими отягчающим отягчающие
установление: установлении установление
употребление: употреблением
устранить: устранена
изготовить: изготовленных
ссылка: ссылкой ссылки
существенный: существенные
формирование: формированием формировании
возобновляться: возобновляется
окончательно: окончательно
правомерность: правомерности
присяжный: присяжными присяжных
пункт: пунктами пунктом
явный: явное
перегрузка: перегрузкам
связанный: связанными связанных связанные связанном
должный: должен должны должно должна
злостный: злостным злостных злостного
распоряжение: распоряжение распоряжения распоряжением
открытие: открытием
снятие: снятии
старший: старше
религия: религии
неожиданность: неожиданности
прошедшее: прошедшее
государственный: государственный государственных государственным государственной государственного
потерпеть: потерпевшему
частичный: частичном частичного
заболевание: заболевания
гражданин: гражданам гражданина граждан граждане гражданину
средство: средств средства средствами средством
контроль: контроля контроль
отбыть: отбытой отбытый отбывших отбыло отбытое
устраняться: устранялась
исполнять: исполняющего исполнял
обслуживание: обслуживания
взыскиваться: взыскиваться
создание: создание создания
прекурсор: прекурсоров
какой: какие
взнос: взносам
инвалид: инвалидами
добровольный: добровольное добровольным добровольном добровольный
внимательность: внимательности
основание: основаниях оснований основание основании основаниям основанием основания
предвидеть: предвидело предвидеть
предварительный: предварительного предварительному
объективно: объективно
ответственность: ответственность ответственности
пожизненный: пожизненное пожизненного пожизненному пожизненным
исключение: исключением
устройство: устройств
определить: определено
пропаганда: пропаганды
действие: действие действий действиями действия
приведение: приведение
изобличение: изобличению
очередной: очередного
пятый: пятой пятых
оборот: оборотом
оружие: оружия
зона: зоне
выявление: выявлении
три: трем трех три
понятие: понятие
весь: всех всего
беззащитный: беззащитного
трудоспособность: трудоспособности
вменяемый: вменяемое
мир: мира
лечение: лечение лечению лечения
устанавливать: устанавливает устанавливающий
регулировать: регулируемых
изменять: изменять
шестидесятилетний: шестидесятилетнего
р: р
объединение: объединением объединениям
суд: суде суд суда судом
припас: припасов
реализация: реализации
судебный: судебное судебного
угроза: угрозы угрозой
хулиганство: хулиганство
бездействие: бездействием бездействие бездействия
следователь: следователя
надзор: надзор
иметься: имеющиеся имеется
основа: основе
исполнительный: исполнительной
психика: психики
экологический: экологической
подать: поданной
присоединение: присоединение
перечислить: перечислило
насилие: насилием насилия
давность: давности
выгода: выгоды
объём: объеме
культура: культуры
величина: величине величины
отсутствовать: отсутствует
добыть: добытого добытые
воздействие: воздействие
примирение: примирением
скрыться: скрылся
конституционно-правовой: конституционно-правового
мероприятие: мероприятиях мероприятий
обещать: обещавшее
воинский: воинских воинского воинской воинском
пространство: пространства пространстве
применять: применяя применяемые
восемнадцатилетний: восемнадцатилетнего
хищение: хищения хищение
участвовать: участвовавшее участвовали участвовать
средний: средней
явиться: явившегося явилось
здравоохранение: здравоохранения
нуждаться: нуждается
муниципальный: муниципального муниципальных
одежда: одежды
вынесение: вынесения
прямо: прямо
многий: многих
остальной: остальные
внесение: внесения внесении
начало: начала
автомобиль: автомобилем
море: моря
снисхождение: снисхождения снисхождении
кража: кражу
свобода: свобод свободы
особенный: особенной
нести: нести несут несет
желать: желало
классный: классного
невменяемость: невменяемость невменяемости
реальный: реальному реального
негодность: негодность
специально: специально
железнодорожный: железнодорожного
проживать: проживающим проживающие проживающего
продление: продление
дело: дело дел дела делу
иммунитет: иммунитетом
основной: основные основной
предмет: предметы предмета
содействие: содействии
банкротство: банкротство
исчислять: исчисляемом исчисляемый
рассрочка: рассрочкой
хронический: хронического
унижение: унижение
угон: угон
признание: признания признании
условно: условно
дать: данному
взрывной: взрывных
достижение: достижения достижение
медицинский: медицинской медицинскую медицинского
садизм: садизмом
мужчина: мужчинам
сумма: суммы сумму сумме
создать: создана создавшее
документ: документом документов
наркомания: наркоманией наркомании
замена: замене замены замена
текст: текст
район: районе
декларант: декларантом
прямой: прямым
перспектива: перспективы
тюрьма: тюрьму тюрьме
перечислять: перечисляемые
незаконно: незаконно
аморальность: аморальность
раз: раза раз
специальный: специального специальной
подлежать: подлежат подлежит
шесть: шести шесть
какой-либо: какие-либо какой-либо какого-либо
альтернатива: альтернатива
раскрытие: раскрытию
законный: законных законную
наступить: наступившие
л: л
восемьдесят: восьмидесяти
предоставить: предоставлены
з: з
способствование: способствование
оказание: оказание
изменение: изменением изменение изменения изменений
согласие: согласия
мотив: мотивам мотивов мотивами мотиву
присоединяться: присоединяется
перечисление: перечисления
вымогательство: вымогательство
определение: определение определении определения
подготовка: подготовке подготовки
одурманивать: одурманивающих
ввести: введен введено введена
содержаться: содержавшемуся содержится содержатся
мучение: мучениями
принуждение: принуждения принуждение
тип: типа
обвинительный: обвинительного
изнасилование: изнасилование
облегчить: облегчить
значительный: значительный
n: n
сложение: сложении сложения
сведение: сведения
прохождение: прохождение
освобождаться: освобождавшемуся освобождается
определяться: определяются определяется
сокращение: сокращению
н: н
выплата: выплаты
стократный: стократной
учёт: учетом
дважды: дважды
аналог: аналогов
умысел: умыслом
судно: судне
организация: организацией организации организацию
задержание: задержании задержания
идеологический: идеологической
оценить: оценить
осуществление: осуществления осуществлению осуществлением
награда: наград
дислоцироваться: дислоцирующихся
предусматривать: предусматривающей предусматривающие предусматривающего
производиться: производится производятся
сорок: сорок
страдание: страданий
уговор: уговора
договор: договором договора
возраст: возрасте возраста возраст
отменить: отменить отменено
след: следы
функция: функции
актив: активов
звание: звании звания
самостоятельно: самостоятельно
уклониться: уклонился
контролировать: контролируемыми
ип: ип
присвоение: присвоения
тридцать: тридцати
считать: считать
стечение: стечения
принять: принятого
законность: законности
военнослужащий: военнослужащим военнослужащие военнослужащих
общеобразовательный: общеобразовательной
приобретение: приобретением приобретение приобретения
представитель: представителей представителя
отвечать: отвечают
это: этим этого этом
инспекция: инспекциями инспекцией
пятнадцать: пятнадцати пятнадцать
член: члена члены
отсрочка: отсрочка
юрисдикция: юрисдикции
бесплатный: бесплатных
избрать: избрать
преследование: преследования преследованию
есть: есть
гражданство: гражданства
опасность: опасности опасность
нервно-психический: нервно-психическим
привести: привели
половина: половины
обеспечение: обеспечения обеспечение
политика: политики
засчитывать: засчитывает
заглаживание: заглаживание
препарат: препаратов
вещество: веществ
самонадеянно: самонадеянно
недостаточный: недостаточным
указать: указанным
испытательный: испытательный испытательного
одновременно: одновременно
бедствие: бедствия
п: п
имущество: имуществом имущества
противоправность: противоправность
выслуга: выслуги
окончить: оконченное оконченным
охранять: охраняемых охраняемым
отслужить: отслужили
смягчать: смягчает
отменяться: отменялись
чин: чина
определять: определяемом определяемых определяет
усиливать: усиливающий
третейский: третейского
нарушитель: нарушителем
сфера: сфере
путь: путей
возможность: возможность возможности
долг: долга
катастрофа: катастрофы
педагогический: педагогическим
ук: ук
качество: качестве качеств
чрезвычайный: чрезвычайного
решение: решением решения решение
человечество: человечества
окружающий: окружающей
равенство: равенства
восемнадцать: восемнадцати
оказаться: оказалось
открытый: открытом
использование: использования использованием
положение: положения положение положений
доказать: доказал доказать
представление: представления представлению
сотрудничество: сотрудничестве
служить: служить
проживание: проживания
окончательный: окончательное
сохранение: сохранение сохранении
оно: оно
неприкосновенность: неприкосновенности
отменять: отменяет
терроризм: терроризма
лечебный: лечебное
национальность: национальности
образование: образования
доверие: доверия
образ: образом
шестнадцатилетний: шестнадцатилетнего
сокрытие: сокрытие
вводиться: вводятся
религиозный: религиозной
присоединить: присоединены
друг: другом
декларация: декларации
крайний: крайняя крайней
ред: ред
час: часов
исчисляться: исчисляется исчисляться исчисляются
влияние: влияние
жестокость: жестокостью
ущерб: ущерб ущерба
специализированный: специализированного
утратить: утратил утратила
признавать: признаваемые
источник: источников
наркотический: наркотических
транспортный: транспортных транспортным
далее: д
влечь: влекущего влечет влекут
опьянение: опьянения
пять: пяти пять
возлагать: возлагает
товар: товаров
большой: больше
неприменение: неприменение
учредитель: учредитель
достаточный: достаточные достаточных
непосредственно: непосредственно
вменение: вменение
она: она
объективный: объективное
тысяча: тысяч
консультантплюс: консультантплюс
территория: территории
беременный: беременной
уклонение: уклонения уклонением
постановлять: постановляет
исполнитель: исполнителя исполнителем
правило: правила правилам
посягать: посягающих посягающие посягающему
устойчивый: устойчивой
проходить: проходящим
издавать: издаваемыми
переместить: перемещенных
прокурор: прокурора
задача: задач задачи задачами
довольствие: довольствия
вино: вина
iii: iii
выполнение: выполнением выполнении
среда: среды
командование: командованием
шестьдесят: шестидесяти
нужда: нужд
конец: конца
ношение: ношение
решаться: решается
зачисление: зачислением
наполовину: наполовину
небольшой: небольшой
требование: требованиям
рассмотрение: рассмотрении
помещение: помещения помещении
приписать: приписанном
бюджетный: бюджетной
акт: акте акты актами акт
правовой: правовыми правовое
неизбежность: неизбежность
распространяться: распространяется распространяются
общепризнанный: общепризнанных
сокрытый: сокрыты
потенциально: потенциально
гуманизм: гуманизма
страдать: страдают страдающего
вандализм: вандализм
служебный: служебного служебной
оправдание: оправдания
-: -
семь: семи
невозможный: невозможным
раздел: раздел
полтора: полтора
аналогия: аналогии
арбитр: арбитра
заниматься: заниматься
алкоголь: алкоголя
стража: стражей
отбываться: отбывается отбываются
раса: расы
счесть: сочтет
ходатайство: ходатайства
национальный: национальной
соответствие: соответствии
достоинство: достоинства
общество: общества
полезный: полезных полезной
признанный: признанному
провозглашение: провозглашения
насильственный: насильственные
особо: особо
м: м
массовый: массовых
примечание: примечание
вправе: вправе
приказ: приказ приказа
зависимость: зависимости
справедливость: справедливости
общественно: общественно
семья: семьи
iv: iv
направляться: направлялось
устранение: устранения устранением
недоведение: недоведения
представляться: представлялось
совет: советами
моральный: морального
спор: споров
пятьсот: пятисот
дополнить: дополнить
отставание: отставания
сутки: суток
обратиться: обратиться
сотрудник: сотрудником
предшествовать: предшествующих
включение: включению
уголовно-процессуальный: уголовно-процессуального
управлять: управляющего
отказаться: отказавшееся отказалось
охрана: охрана
человеческий: человеческого
спорт: спорта
корабль: корабле
снятой: снятые
касаться: касающихся
нахождение: нахождения
убеждение: убеждений
слабоумие: слабоумия
нарушать: нарушал
двести: двести
сознательно: сознательно
вердикт: вердикте вердиктом
независимо: независимо
перевозка: перевозку
воспитание: воспитания воспитанию
неправомерный: неправомерное
седьмой: седьмой
получение: получения
постановить: постановить
заработный: заработной
менять: менять
сохранить: сохранило
обеспечивать: обеспечивает
сексуальный: сексуального
захват: захват
полова: половой
проведение: проведения
неосторожный: неосторожные
штрафной: штрафном
взятка: взятки
досудебный: досудебное досудебного
фактически: фактически
домашний: домашним
легкомыслие: легкомыслию
кратный: кратной
четыре: четырех
задержать: задержать
контракт: контракту
уменьшать: уменьшающих
обороняться: обороняющегося
третий: третьей третья
последний: последнему
групповой: группового
заказчик: заказчика
территориальный: территориального
избежать: избежать
сбыть: сбыть
рассмотреть: рассмотрено
венерический: венерического
власть: власти
инструмент: инструментов
непосредственный: непосредственной
риска: риске
убыток: убытков
эквивалентный: эквивалентную
радиоактивный: радиоактивных
несколько: нескольких
курс: курс
небрежность: небрежности
совместно: совместно
санкция: санкции
направление: направления
доведение: доведение доведения
подкуп: подкупа
передача: передачу
вина: вины
редакция: редакции
дипломатический: дипломатических
вызвать: вызванном
часы: часах
искусство: искусства
процент: процентов
временной: временного
уплата: уплаты
ещё: еще
отказ: отказом отказ
рядовой: рядового
повысить: повышен
постоянно: постоянно
случайный: случайного
наступать: наступает
приспособление: приспособление
исполняться: исполняться исполняются
систематически: систематически
наложить: наложено
близкий: близких
никто: никто
трудоустроиться: трудоустроиться
преступность: преступность
препятствие: препятствий
умышленно: умышленно
развитие: развития развитии
отдых: отдыха
рубль: рублей
регистрация: регистрации
задерживать: задерживаемым
изготовление: изготовление
имитировать: имитирующих
четыреста: четырехсот
улучшать: улучшающий
похищение: похищение
более: более
отдать: отдавшее
родитель: родителем
сострадание: сострадания
чрезмерный: чрезмерный
частично: частично
прийти: придет
приостанавливаться: приостанавливается
профессиональный: профессиональной
психоактивный: психоактивных
поддержка: поддержки
боеприпас: боеприпасов
оздоровление: оздоровления
сбор: сборам
течение: течение
отдельно: отдельно
шестидесятипятилетний: шестидесятипятилетнего
самоуправление: самоуправления
освобождать: освобождает
уничтожение: уничтожение
материальный: материальной
своевременный: своевременным
изоляция: изоляции
компания: компаниями
менее: менее
указание: указаниями указанием
наказуемость: наказуемость
конституция: конституции
ii: ii
ст: ст
сбыт: сбыт
плата: платы
форменный: форменной
